111111111111111111111111111111
100000000000000000000000000001
100000011111100000000000000001
100000000000000000000000000001
100000000000000000000000000001
100000000000000000011110000001
100000000000000000000000000001
100000000000000000000000000001
100000000000000000000000000001
100001131111111100000000000001
100001020000000000000000000001
100001020000000000000000000001
100001020000010000000000000001
100001020000010000000000000001
100011111131110000000000000001
100000001020000001111113111001
100000001020000001000002000001
100000001020000001000002000001
1000000D10200000K1000002P00001
111111111111111111111111111111