111111111111111111111111111111
1OOOOOOOOOOOOOOOOOOOOOOOOOOOO1
100000000000000000000000000001
100000000000000000000000000001
100000000000000000000000000001
100000000000000000000000000001
100000000011111111111111000001
100000000010000000000000000001
111110000110000000000000000001
1000000O000000000000OO00000001
100000000000000000000001111111
100111111111111111000000000001
100000000000000000000000000001
100000000000000000111000000001
100000000000000000111000000001
100000000000000000000000000001
101111100000001111111111100001
101000100000000001000000000001
100010000000000001000000000001
111111111111111111111111111111