111111111111111111111111111111
1OOOOOOOOOOOOOOOOOOOOOOOOOOOO1
100000000000000000000000000001
100000000000000000000000000001
100000000000000000000000000001
100000000000000000P00000000001
100000000011111311131111000001
100000000010000200020000000001
113110000110000200020000000001
1020000O000000020002OO00000001
102000000000000200020001111111
102111111113111111020000000001
102000000013100000020000000001
102000000013100000131000000001
102000000002000000131000000001
101311100002000000020000000001
101200100002001111111311100001
101200000002000001000200000001
100211100002000001000200000001
111111111111111111111111111111