111111111111111111111111111111
111111111111111111111111111111
111111111D00000A11111111111111
111111111113111111111111111111
111111111102001111111111111111
1111111111020000000000000000C1
111111111111111111111113000011
100000000000101010101012000011
1131111111111B1B1B1B1B11113111
10210000001011111111111C0020C1
1021B00000100000C00A0011113111
10211111111000131111001C0020C1
102000000010001311110011113111
10200000001000131111001C0020C1
102000000010001311110011113111
111111131111111311110000002001
100000020110000201111111111111
10P000020110000201110000000001
1111111111100K02011100000000B1
111111111111111111111111111111