111111111111111111111111111111
111111111111111111111111111111
111111111D00000A11111111111111
111111111113111111111111111111
111111111102001111111111111111
111111100A02000000000000000001
111111111111111111111113000001
100000000000100000000012000001
113111111111100000000011113111
102000000010000000000011113111
1A2000000010001311110011113111
11111111311000131111001A002111
100000002010001311110011113111
100000002010001311110011113111
100000002010001311110011113111
100000031111111311110011113111
1000000201100002011100000020A1
10P000020110000201111111111111
1111111111100K0201111111111111
111111111111111111111111111111