111111111111111111111111111111
100000000000000000000000000001
100000000000000000000000000001
100000000000000000000000000001
100000000000000000000000000001
100000000000000000P0K000000001
100000000011111311131111000001
100000000010000200020000000001
113110000110000200020000000001
1020000000000002000200000E0001
102000E00000E00200020001111311
102111111113111111020000000201
102000000013100000020000000201
102000000013100000131000000201
102000000002000000131000000201
101311100002000000020000000201
101200100002001111111311100201
101200000002000001000200000201
1002111000020000D1000200000201
111111111111111111111111111111