111111111111111111111111111111
111111111111111111111111111111
111111111D00000A11111111111111
111111111113111111111111111111
111111111102001111111111111111
1111111111A20000000000000000C1
111111111111111111111113000011
100000000000111111111112000011
113111111111100000000011113111
1020000000100000C000001C0020C1
1A2000000010001311110011113111
11111111311000131111001C0020C1
100000002010001311110011113111
10000000201000131111001C0020C1
100000002010001311110011113111
100000031111111311110000002001
100000020110000201111111111111
10P000020110000201110000000001
1111111111100K02011100000000B1
111111111111111111111111111111