111111111111111111111111111111
100000000000000000000000000001
100000000000000000000000000001
100000000000000000000000000001
100000000000000000000000000001
100000000000000000000000000001
100000000000000000000000000001
100000000000000000000000000001
1000000000000000000000000CCCC1
100001131111111113111111111111
10000102000000C102000000000001
1000010200000C1102000000000001
100001020000C11102000000000001
100001020000111102000000000001
100001111131111102A000000000C1
100001111020011111111113111111
100000001020011111000002000001
100000001020000001000002000001
1A00000D1020000AK1000002P00001
111111111111111111111111111111