111111111111111111111111111111
100000000000000D00000000000001
100000000000000130000000000001
100000000000000020000000000001
100000000000000020000000000001
100000000000001131100000000001
100000000000000020000000000001
100000000000000020000000000001
10K0000A0000000020000000000001
111111111111111111111310000001
100000000000000000000200000001
100000000000000000000200000001
100000000000000000000200000A01
100000000000113111111111111111
100000000000002000000000000001
100000000000002000000000000001
100000000000002000000000000001
100000000000002000000000000001
1000A0000000002000000000P00001
111111111111111111111111111111